default_graphic
12
3	4	4	4	4	4	4	4	4	4	4	4	4	4	4	4	4	4	2
5	0	0	0	0	0	0	0	0	0	0	0	0	0	0	0	0	0	5
5	0	1	0	1	0	1	0	1	0	1	0	1	0	1	0	1	0	5
5	0	0	0	0	0	0	0	0	0	0	0	0	0	0	0	0	0	5
5	0	1	0	1	0	1	0	1	0	1	0	1	0	1	0	1	0	5
5	0	0	0	0	0	0	0	0	0	0	0	0	0	0	0	0	0	5
5	0	1	0	1	0	1	0	1	0	1	0	1	0	1	0	1	0	5
5	0	0	0	0	0	0	0	0	0	0	0	0	0	0	0	0	0	5
5	0	1	0	1	0	1	0	1	0	1	0	1	0	1	0	1	0	5
5	0	0	0	0	0	0	0	0	0	0	0	0	0	0	0	0	0	5
5	0	1	0	1	0	1	0	1	0	1	0	1	0	1	0	1	0	5
5	0	0	0	0	0	0	0	0	0	0	0	0	0	0	0	0	0	5
7	4	4	4	4	4	4	4	4	4	4	4	4	4	4	4	4	4	6